18 15
1 7
16 1
##################
#.X.X.X....X.X.X.#
#.######..######.#
#X...X..XX..X...X#
###.#.######.#.###
#XXX#X.X....X#.X.#
#.#X##..##XX##X#.#
#.#...XX##XX...#.#
#.#.##XX##..##.#.#
#X..#X...X..X#..X#
###.#.######.#.###
#X.X.X..XX..X.X.X#
#.######..######.#
#X..X...XX...X..X#
##################